1111111111111
1000000100001
11111010000001
11011010110001
11000010000001
11111000111001
10000011111111
10000000000001
11010101010101
11011111111111
11011111111111111111